aa	AA
ae	EY
ah	AA
ao	EY OW
aw	AO
ay	EY
ay(2)	AY
b	B IY
ch	S IY
d	D IY
dh	D IY
eh	EH
er	ER
ey	IY IY
f	EH F
g	JH IY
hh	EY CH
ih	IY
iy	Y IY
jh	JH EY
k	K EY
l	EH L
m	EH M
n	EH N
ng	EH NG
ng(2)	IH NG
ow	OW
ow(2)	AW
oy	OY
p	P IY
r	AA R
s	EH S
sh	EH S
t	T IY
th	T IY EY CH
uh	AH
uw	AH W
v	V IY
w	D AH B AH L Y UW
y	W AY
z	Z IY
zh	Z IY